111111111111111111111
10010E00000C000000001
100001111100000000001
100011000000000C00001
10000000EP00000000001
1000000EEE00000000001
10000000E0C0000000001
100000000000000000001
111111110000111111111
111111110000111111111
111111110000111111111
111111110000111111111
111111110000111111111
111111110000111111111
111111110000111111111
111111110000111111111
111111110000111111111
111111110000111111111
111111110000111111111
111111110000111111111
111111110000111111111
111111110000111111111
111111110000111111111
111111110000111111111
111111110000111111111
111111110000111111111
11111111000E111111111
111111111111111111111
111111111111111111111
111111111111111111111
111111111111111111111
111111111111111111111
111111111111111111111
111111111111111111111
111111111111111111111
111111111111111111111
111111111111111111111
111111111111111111111
111111111111111111111
111111111111111111111
111111111111111111111
111111111111111111111
111111111111111111111
111111111111111111111
111111111111111111111
111111111111111111111
111111111111111111111
111111111111111111111
111111111111111111111
111111111111111111111
111111111111111111111
111111111111111111111
111111111111111111111
111111111111111111111
111111111111111111111
111111111111111111111
111111111111111111111
111111111111111111111
111111111111111111111
111111111111111111111
111111111111111111111
111111111111111111111
111111111111111111111
111111111111111111111
111111111111111111111