111111111111111111111
10010E00000C000000001
100001111100000000001
100011000000000C00001
10P000000000000000001
10000000C000000000001
100000000000000000001
1000000000000000C0001
111111111111111111111