111111111111111111111
1C010E000000000000001
100001111100000000001
10001100000000C000001
10000000000E000000001
10000000P000000000CC1
1000000000C0000000001
100000000000000000001
111111111111111111111